###############################
#p  *     *   *   *  * 2      #
# # # # # # # #*#*# # # # # # #
# *f* b * *   f *   * *   *   #
# # # # # #*#*# # # # # # # #*#
#s*           *   * b   *   * #
# # # # # # # # # # # # # #*# #
#   * x *     *    *  * *   1 #
# # #*# # # # # # # # # # #*# #
#   f     * b       *  *    * #
#*# # #*# # # # #*# # #*# # # #
#   *   *   * * *     *       #
# #*# # #*# # # # # #*# # #*#*#
#   * 1    *    *    *1       #
###############################