###############################
#p    s   * *  2    **     1  #
# # #*# # # # # # # # # # # # #
#       * *     *   * *   *   #
# # # # # #*#*# #*# # # # # # #
#   * *       b   *   2 *   * #
# # #b# # # # # # # # # # #*# #
# *   * *  1  *    *  *       #
#f#*# #*#*#*# # # # # # # #*# #
#   *     f         * *  3  * #
# # # #*# # # #*#*# # # #*# # #
#   *     * *                 #
#*#*# #*# # # # #*# # #*# # # #
#    *   1       *        *   #
###############################