###############################
#p    *       f     **     1  #
# # # #b# # # # # # # # # # # #
# *     * *         * *   *   #
# #*#s#x# #*#*# # # #1# # # # #
# f           b   *     *   * #
# #*# # # # # # # # # # # #*# #
#   *   *  1  *    *  *       #
#*# # # #*#*# # # # # # # #*# #
# *   *   s         *       * #
# #*#*# # # # # #*# # # #*# # #
#     2     *                 #
# #*# # #*# # # #*# # #*# # # #
#       *        *    1   *   #
###############################