###############################
#p    s   * *  2    **     1  #
# # #*# # # # # # # # # # # # #
#       * *     *   * *   *   #
# # # # # #*#*# #*# # # # # # #
#   * *       b   *     *   * #
# # #b# # # # # # # # # # #*# #
#     * *  1  *    *x *       #
#f#*# #*#*#*# # # # # # # #*# #
#   *     f         * *     * #
# # # #*# # # #*#*# # # #*# # #
#   *     * *                 #
# #*# #*# # # # #*# # #*# # # #
#    *   1       *        *   #
###############################