###############################
#p *  *     * 1   * **     1  #
# # # #b# # #*#*#*# # # # # # #
# *     * *   * *   * *   *   #
#s# #*#x# #*#*# # # # # # # # #
# *           *   * b   *   * #
# # # # # # # # # # # # # #*# #
#  f*   *     *    *  *       #
#*# # #*#*#*# # # # # # # #*# #
# *   *   f   b     *  *    * #
# #*#*# # # # # #*# # #*# # # #
#     2       * *     *       #
# #*# # #*# # # # # #*# # #*#*#
#       *            *1       #
###############################