###############################
#p     ** *  1 * 2 *  * * *   #
# # # #*# # #*#*# # # #*#*#*# #
#  x* s   ***  *  1   * 2 * * #
# # # # # #*# # #*#*# # # # #*#
#f         b **  *  *   1     #
# # # # # # # # # #*# #*# # # #
#*  *  3   *  *      *        #
# # # # #*# # # #*#*# # # # # #
#*    **  *       *           #
# #*# # # # # # #*# # # # # # #
#    3      *   *  *          #
# #*# # # # # # #*# # # # # # #
#    *      *        *   *    #
###############################