###############################
#         *   *   b    *      #
# # # #*# # #*#*# # # #*#*# # #
#    *      *     *  3     *  #
# # # # # #*# # # #*# # # # #*#
#   s *   *     *   2   *     #
# # # # # # # # # #*# #*# # # #
#  2      * 1   *     *       #
# # # # #*# # # #*#*# # # # # #
#    1   *   *      *     *   #
# #*# # # # # # #*# # # # # # #
#    *      *  f     *        #
# #*# # # # # # #*# # # # # # #
#         *        *          #
###############################