###############################
#p    *       f     **     1  #
# # # #b# # # # # # # # # # # #
# *     * *         * *   *   #
# #*#s#x# #*#*# # # #1# # # # #
# f           b   *     *   * #
# #*# # # # # # # # # # # #*# #
#   *   *     *    *  *    3  #
#*# # # #*#*# # # # # # # #*# #
# *   *   s     2   *       * #
# #*#*# # # # # #*# # # #*# # #
#     2     *                 #
# #*# # #*# # # #*# # #*# # # #
#       *        *    1   *   #
###############################