###############################
#p     ** *  1 *   *  * * *   #
# # # #*# # #*#*# # # #*#*#*# #
#  x* s   ***  *      *   * * #
# # # # # #*# # #*#*# # # # #*#
#f         b **  *  *   2     #
# # # # # # # # # #*# #*# # # #
#*  *      *  *      *  3     #
# # # # #*# # # #*#*# # # # # #
#*    **  *   1   *           #
# #*# # # # # # #*# # # # # # #
#           *   *  *    2     #
# #*# # # # # # #*# # # # # # #
#    *      *        *   *    #
###############################